1                                                                                                                      
1                                      4    2                                                                          
1                                           2                   F               1111111 1111111111                          
1                                           2                 11111                           1                  11111111
1                                           2                 11111                           1                  3      3     4
1                                   2223333 2                 111111                          1                  3      3
1                              111          2                                                 1                  3   G  3    
1                              111          2                                     H           1 F                11111111   11111
1                            11111          2                                   1111          1111                         111111
1                            11111          2                                  11111          1                    K      1111111
1                          1111111          2                    F             11111          1                  1111111111111111
1  a       111     111     1111111          2    F             11111                          1                  1111111111111111
111111111111111   1111111111111111          2  11111                                          1                  1111111111111111