11111111111111111111111111111111111111111111111111111111111111111111
1     2                      2               K            3        1
1     2                      2                            3        1
1     2                      2                            3        1
1     2                      2                            3        1
1 a   2                      2 w  66    y                 3   G    1
1111111111111111111111333331111111111111111111111         1111111111   
1     2            3    5                                     5    1
1     2            3                                               1
1 5   2            3                                               1
1     2            111111111              1111111         1111111111
1 b   2            1       1              1     1         1
11111111111111111111       1666666666666661     1   777   1


                           1  x  x  x  x  1