1
1
1
1 a                    w       
11111111111111111111111111111111111    111111
1                                 
1                                 
1                               
1                                            1111111111111111
1                                            1
1         1      1        1        1         1
1      b  1      1        11      11    1   11
111111111111111111111111111111111111  11111111