111111         
1              d
1              2
1 a   b    3   2      K            
1111111111111111111122222221111111111    111111
1                                 
1                                 
1                               
1                                            1111111111111111
1         G                                  1
1         1      1           1         1     1
1         1      1          11        11    11
111111111111111111111111111111111111  11111111