1              e
1              d
1              1
1 a   b  w   c 1                  
11111111111111111111111111111111111    111111
1                                 
1                                 
1                               
1                                            1111111111111111
1                                            1
1         1      1           1         1     1
1         1      1          11        11    11
111111111111111111111111111111111111  11111111