111111         
1              d
1              1
1 a   b      y 1                  
11111111111111111111         1111111111    111111
1                                 
1                                 
1                               
1                                            1111111111111111
1                                            1
1         1      1           1         1     1
1         1      1          11        11    11
111111111111111111111111111111111111  11111111